Monday Mornings
An Interactive Fiction by Neha Marlady
Release 1 / Serial number 250806 / Inform 7 v10.1.2 / D

Credits Thanks YouTube channel Zoroarrkk,helped with the setup and tutorial of inform7.
https://inform-7-handbook.readthedocs.io/en/latest/ for helping me in understanding the different concepts of inform7.
And ChatGPT for assistance with English grammar correction.

The time is now 8:00 am Monday Morning, You wake up to the soft glow of the early morning sun filtering through the curtains.
Your target is to get ready to office by 8:30 AM.

Bedroom
The bedroom is a quiet, comforting space, with a thick, soft bed tucked against the wall and a warm blanket on the bed. Faint light filters through the curtains, and the gentle hush of the room invites sleep.

You can see a Night stand (on which is Smart phone), a drawer (closed) and Wardrobe (closed) here.

>check phone
A sleek, modern smartphone rests on the nightstand. Its screen is alive with activity, glowing with several notifications from Facebook, X and Instagram.

>open drawer
You open the drawer, revealing a key.

>take key
Taken.

>open wardrobe
You open Wardrobe, revealing a pajamas, a casual clothes and a formal clothes.

>take formal clothes
Taken.

>look
Bedroom
The bedroom is a quiet, comforting space, with a thick, soft bed tucked against the wall and a warm blanket on the bed. Faint light filters through the curtains, and the gentle hush of the room invites sleep.

You can see a Night stand (on which is Smart phone), a drawer (empty) and Wardrobe (in which are a pajamas and a casual clothes) here.

>go bathroom
You can't see any such thing.

>w
You can't go that way.

>e
You can't go that way.

>s
Dinning room
The dining room is bright and tidy, with a long wooden table at the center surrounded by sturdy chairs. A small chandelier hangs overhead, casting a warm glow across the room.

You can see a table (on which are News Paper and Breakfast) here.

>have breakfast
That's not a verb I recognise.

>eat breakfast
Yummy breakfast to boost your energy and keep you full for the day. Now the time is 8:17 am.

>read paper
Lost in the stories and headlines of the newspaper, you barely notice the minutes ticking by. Now the time is 8:33 am.

>w
You can't go that way.

>e
Hall
The hall is a wide, open space with polished floors and plain walls. A few paintings hang neatly along the sides. The main door is to the south of the hall

You can see Main door, Sofa and TV here.

>watch TV
 The news headline and then the sports news took your time that you did not notice the time. Now the time is 9:06 am.

>sit in sofa
That's not something you can sit down on.

>sit on sofa
Comfy sofa, best place to sit and relax or Watch TV. Now the time is 9:10 am.

>open main door
It seems to be locked.

>unlock main door
The main door is unlocked.

>open main door
You open Main door.

>w
Dinning room
The dining room is bright and tidy, with a long wooden table at the center surrounded by sturdy chairs. A small chandelier hangs overhead, casting a warm glow across the room.

You can see a table (on which are News Paper and Breakfast) here.

>s
You can't go that way.

>e
Hall
The hall is a wide, open space with polished floors and plain walls. A few paintings hang neatly along the sides. The main door is to the south of the hall

You can see Main door, Sofa and TV here.

>e
You can't go that way.

>s
You run outside .. but its already 9:18 am.. YOU ARE LATE TO THE WORK.

    *** You lost to the Monday Morning. ***

Would you like to RESTART, RESTORE a saved game, QUIT or UNDO the last command?

* * *

>examine
(Smart phone)
You've been so absorbed in your phone, scrolling through notifications and messages, that you didn't even realize how much time has slipped away. Now the time is 8:25 am.

* * *

>examine drawer
The drawer slides open with a faint creak, revealing a shallow space inside, perfect for keeping personal and importandt items.

>open drawer
You open the drawer, revealing a key.

* * *

>take key
Taken.

>i
You are carrying:
  a key

>close the drawer
You close the drawer.

>i
You are carrying:
  a key

* * *

>examine drawer
The drawer slides open with a faint creak, revealing a shallow space inside, perfect for keeping personal and importandt items.

>openn drawer
That's not a verb I recognise.

>open drawer
You open the drawer, revealing a key.

>pick key
I didn't understand that sentence.

>take key
Taken.

* * *

>i
You are carrying:
  a key

>k
That's not a verb I recognise.

* * *

>examine night stand
The nightstand is short and sturdy

On the Night stand is Smart phone.

>examine drawer
The drawer slides open with a faint creak, revealing a shallow space inside, perfect for keeping personal and importandt items.

>examine wardrobe
A large wooden wardrobe stands against the wall. Its doors are slightly ajar, revealing an organized collection of clothes inside. On one side, neatly hung pajamas, casual clothes, and formal attire are arranged by type and color.

>open drawer
You open the drawer, revealing a key.

* * *

>open wardrobe
You open Wardrobe, revealing a pajamas, a casual clothes and a formal clothes.

>wear formal clothes
(first taking the formal clothes)
Perfect clothes to wear to office. You are now set to go to office. Now the time is 8:11 am.

>s
Dinning room
The dining room is bright and tidy, with a long wooden table at the center surrounded by sturdy chairs. A small chandelier hangs overhead, casting a warm glow across the room.

You can see a table (on which are News Paper and Breakfast) here.

>examine news paper
A neatly folded newspaper lies on the table, the front page flashing an exciting headline about a thrilling last-minute victory in last night's big game. It's the kind of story that makes you want to read every detail.

>examine breakfast
A hearty breakfast is laid out: a plate of buttered toast, a bowl of fresh fruit, a pot of steaming coffee, and a jar of strawberry jam. The warm, comforting smells fill the air, making the whole room feel inviting.

>eat breakfast
Yummy breakfast to boost your energy and keep you full for the day. Now the time is 8:23 am.

>e
Hall
The hall is a wide, open space with polished floors and plain walls. A few paintings hang neatly along the sides. The main door is to the south of the hall

You can see Main door, Sofa and TV here.

>eamine main door
That's not a verb I recognise.

>eamine sofa
That's not a verb I recognise.

>examine main door
The main is opens to the outside world. It is towards the south of the hall.

>examine sofa
A large, deep sofa dominates the room, its soft, dark fabric welcoming you to sit. The cushions are plump and perfectly arranged, with a cozy throw blanket draped across one armrest. It looks like the ideal place for a lazy afternoon.

>examine tv
 The news headline and then the sports news took your time that you did not notice the time. Now the time is 8:57 am.

>s
(first opening Main door)
It seems to be locked.

>unlock door
The main door is unlocked.

>s
(first opening Main door)
You run outside .. but its already 9:00 am.. YOU ARE LATE TO THE WORK.

    *** You lost to the Monday Morning. ***

Would you like to RESTART, RESTORE a saved game, QUIT or UNDO the last command?

>restart
Monday Mornings
An Interactive Fiction by Neha Marlady
Release 1 / Serial number 250428 / Inform 7 v10.1.2 / D

Credits Thanks YouTube channel Zoroarrkk,helped with the setup and tutorial of inform7.
https://inform-7-handbook.readthedocs.io/en/latest/ for helping me in understanding the different concepts of inform7.
And ChatGPT for assistance with English grammar correction.

The time is now 8:00 am Monday Morning, You wake up to the soft glow of the early morning sun filtering through the curtains.
Your target is to get ready to office by 8:30 AM.

Bedroom
The bedroom is a quiet, comforting space, with a thick, soft bed tucked against the wall and a warm blanket on the bed. Faint light filters through the curtains, and the gentle hush of the room invites sleep.

You can see a Night stand (on which is Smart phone), a drawer (closed) and Wardrobe (closed) here.

>open wardrobe
You open Wardrobe, revealing a pajamas, a casual clothes and a formal clothes.

>wear pajamas
(first taking the pajamas)
Perfect clothes to wear at home. Now the time is 8:06 am.

>open drawer
You open the drawer, revealing a key.

* * *

>take key
Taken.

>use phone
You've been so absorbed in your phone, scrolling through notifications and messages, that you didn't even realize how much time has slipped away. Now the time is 8:24 am.

>s
Dinning room
The dining room is bright and tidy, with a long wooden table at the center surrounded by sturdy chairs. A small chandelier hangs overhead, casting a warm glow across the room.

You can see a table (on which are News Paper and Breakfast) here.

>read news paper
Lost in the stories and headlines of the newspaper, you barely notice the minutes ticking by. Now the time is 8:41 am.

>e
Hall
The hall is a wide, open space with polished floors and plain walls. A few paintings hang neatly along the sides. The main door is to the south of the hall

You can see Main door, Sofa and TV here.

>watch tv
 The news headline and then the sports news took your time that you did not notice the time. Now the time is 9:13 am.

>s
(first opening Main door)
It seems to be locked.

* * *

>unlock door
The main door is unlocked.

>s
(first opening Main door)
You run outside .. but its already 9:16 am.. YOU ARE LATE TO THE WORK.

    *** You lost to the Monday Morning. ***

Would you like to RESTART, RESTORE a saved game, QUIT or UNDO the last command?

>RESTART
Monday Mornings
An Interactive Fiction by Neha Marlady
Release 1 / Serial number 250428 / Inform 7 v10.1.2 / D

Credits Thanks YouTube channel Zoroarrkk,helped with the setup and tutorial of inform7.
https://inform-7-handbook.readthedocs.io/en/latest/ for helping me in understanding the different concepts of inform7.
And ChatGPT for assistance with English grammar correction.

The time is now 8:00 am Monday Morning, You wake up to the soft glow of the early morning sun filtering through the curtains.
Your target is to get ready to office by 8:30 AM.

Bedroom
The bedroom is a quiet, comforting space, with a thick, soft bed tucked against the wall and a warm blanket on the bed. Faint light filters through the curtains, and the gentle hush of the room invites sleep.

You can see a Night stand (on which is Smart phone), a drawer (closed) and Wardrobe (closed) here.

>open drawer
You open the drawer, revealing a key.

* * *

>open wardrobe
You open Wardrobe, revealing a pajamas, a casual clothes and a formal clothes.

>wear casuals
You can't see any such thing.

>wear casual clothes
(first taking the casual clothes)
You are wearing casuals.This is good if you are not going to office. Now the time is 8:08 am.

>s
Dinning room
The dining room is bright and tidy, with a long wooden table at the center surrounded by sturdy chairs. A small chandelier hangs overhead, casting a warm glow across the room.

You can see a table (on which are News Paper and Breakfast) here.

>eat breakfast
Yummy breakfast to boost your energy and keep you full for the day. Now the time is 8:18 am.

>e
Hall
The hall is a wide, open space with polished floors and plain walls. A few paintings hang neatly along the sides. The main door is to the south of the hall

You can see Main door, Sofa and TV here.

>s
(first opening Main door)
It seems to be locked.

* * *

>unlock door
The main door is unlocked.

>s
(first opening Main door)
You leave in your casuals. Nobody will take you seriously.

    *** at least, You conquered the morning! ***

Would you like to RESTART, RESTORE a saved game, QUIT or UNDO the last command?

* * *

>open drawer
You open the drawer, revealing a key.

>examine key
 A single, rusted key hangs from a leather strap. It looks old, but you can tell by its shape that it might be the key to the main door.

>take key
Taken.

* * *

>i
You are carrying:
  a key

>examine wardrobe
A large wooden wardrobe stands against the wall. Its doors are slightly ajar, revealing an organized collection of clothes inside. On one side, neatly hung pajamas, casual clothes, and formal attire are arranged by type and color.

>use phone
You've been so absorbed in your phone, scrolling through notifications and messages, that you didn't even realize how much time has slipped away. Now the time is 8:22 am.

>s
Dinning room
The dining room is bright and tidy, with a long wooden table at the center surrounded by sturdy chairs. A small chandelier hangs overhead, casting a warm glow across the room.

You can see a table (on which are News Paper and Breakfast) here.

>e
Hall
The hall is a wide, open space with polished floors and plain walls. A few paintings hang neatly along the sides. The main door is to the south of the hall

You can see Main door, Sofa and TV here.

* * *

>s
(first opening Main door)
It seems to be locked.

>open door
It seems to be locked.

>unlock door
The main door is unlocked.

>s
(first opening Main door)
You're not wearing any clothes! Better do something about that.

>n
You're not wearing any clothes! Better do something about that.

>w
Dinning room
The dining room is bright and tidy, with a long wooden table at the center surrounded by sturdy chairs. A small chandelier hangs overhead, casting a warm glow across the room.

You can see a table (on which are News Paper and Breakfast) here.

>n
Bedroom
The bedroom is a quiet, comforting space, with a thick, soft bed tucked against the wall and a warm blanket on the bed. Faint light filters through the curtains, and the gentle hush of the room invites sleep.

You can see a Night stand (on which is Smart phone), a drawer (empty) and Wardrobe (closed) here.

I beg your pardon?

>open wardrobe
You open Wardrobe, revealing a pajamas, a casual clothes and a formal clothes.

>use formal clothes
You can't see any such thing.

>wear formal clothes
(first taking the formal clothes)
Perfect clothes to wear to office. You are now set to go to office. Now the time is 8:38 am.

>s
Dinning room
The dining room is bright and tidy, with a long wooden table at the center surrounded by sturdy chairs. A small chandelier hangs overhead, casting a warm glow across the room.

You can see a table (on which are News Paper and Breakfast) here.

* * *

>e
Hall
The hall is a wide, open space with polished floors and plain walls. A few paintings hang neatly along the sides. The main door is to the south of the hall

You can see Main door, Sofa and TV here.

>s
You run outside .. but its already 8:41 am.. YOU ARE LATE TO THE WORK.

    *** You lost to the Monday Morning. ***

Would you like to RESTART, RESTORE a saved game, QUIT or UNDO the last command?

>n
Please give one of the answers above.

Would you like to RESTART, RESTORE a saved game, QUIT or UNDO the last command?

* * *

>examine night stand
The nightstand is short and sturdy

On the Night stand is Smart phone.

>examine mobile phone
A sleek, modern smartphone rests on the nightstand. Its screen is alive with activity, glowing with several notifications from Facebook, X and Instagram.

>examine wardrobe
A large wooden wardrobe stands against the wall. Its doors are slightly ajar, revealing an organized collection of clothes inside. On one side, neatly hung pajamas, casual clothes, and formal attire are arranged by type and color.

>open wardrobe
You open Wardrobe, revealing a pajamas, a casual clothes and a formal clothes.

>close wardrobe
You close Wardrobe.

>examine wardrobe
A large wooden wardrobe stands against the wall. Its doors are slightly ajar, revealing an organized collection of clothes inside. On one side, neatly hung pajamas, casual clothes, and formal attire are arranged by type and color.

* * *

>open wardrobe
You open Wardrobe, revealing a pajamas, a casual clothes and a formal clothes.

>examine pajamas
A soft pair of pajamas neatly folded and are tucked into a corner of the wardrobe. Perfect to wear at home.

>close wardrobe
You close Wardrobe.

>examine pajamas
You can't see any such thing.

>s
You can't go that way.

>n
You can't go that way.

>w
You can't go that way.

* * *

>i
You are carrying nothing.

>examine
(Smart phone)
You've been so absorbed in your phone, scrolling through notifications and messages, that you didn't even realize how much time has slipped away. Now the time is 8:26 am.

>look
Bedroom
The bedroom is a quiet, comforting space, with a thick, soft bed tucked against the wall and a warm blanket on the bed. Faint light filters through the curtains, and the gentle hush of the room invites sleep.

You can see a Night stand (on which is Smart phone), a drawer (closed) and Wardrobe (closed) here.

>look night stand
The nightstand is short and sturdy, a smart phone is on the night stand.

On the Night stand is Smart phone.

>examine
(Smart phone)
You've been so absorbed in your phone, scrolling through notifications and messages, that you didn't even realize how much time has slipped away. Now the time is 8:54 am.

>examine bedroom.
You can't see any such thing.

>e
You can't go that way.

* * *

>l
Example Location

* * *

>look
Bedroom
The bedroom is a quiet, comforting space, with a thick, soft bed tucked against the wall and a warm blanket on the bed. Faint light filters through the curtains, and the gentle hush of the room invites sleep.

You can see a Night stand (on which is Smart phone), a drawer (closed) and Wardrobe (closed) here.

>examine
What do you want to examine?

>examine
What do you want to examine?

>examine phone
A sleek, modern smartphone rests on the nightstand. Its screen is alive with activity, glowing with several notifications from Facebook, X and Instagram.

* * *

>look
Bedroom
The bedroom is a quiet, comforting space, with a thick, soft bed tucked against the wall and a warm blanket on the bed. Faint light filters through the curtains, and the gentle hush of the room invites sleep.

You can see a Night stand (on which is Smart phone), a drawer (closed) and Wardrobe (closed) here.

>examine night stand
The nightstand is short and sturdy, a smart phone is on the night stand.

On the Night stand is Smart phone.

>examine drawer
The drawer slides open with a faint creak, revealing a shallow space inside, perfect for keeping personal and importandt items.

* * *

>examine night stand
The nightstand is short and sturdy, a smart phone is on the night stand.

On the Night stand is Smart phone.

>examine smart phone
A sleek, modern smartphone rests on the nightstand. Its screen is alive with activity, glowing with several notifications from Facebook, X and Instagram.

>examine drawer
The drawer slides open with a faint creak, revealing a shallow space inside, perfect for keeping personal and importandt items.

* * *

>examine wardrobe
A large wooden wardrobe stands against the wall. Its doors are slightly ajar, revealing an organized collection of clothes inside. On one side, neatly hung pajamas, casual clothes, and formal attire are arranged by type and color.

>use smart phone
You've been so absorbed in your phone, scrolling through notifications and messages, that you didn't even realize how much time has slipped away. Now the time is 8:20 am.

>s
Dinning room
The dining room is bright and tidy, with a long wooden table at the center surrounded by sturdy chairs. A small chandelier hangs overhead, casting a warm glow across the room.

You can see a table (on which are News Paper and Breakfast) here.

>eat breakfast
Yummy breakfast to boost your energy and keep you full for the day. Now the time is 8:30 am.

>e
Hall
The hall is a wide, open space with polished floors and plain walls. A few paintings hang neatly along the sides. The main door is to the south of the hall

You can see Main door, Sofa and TV here.

* * *

>s
(first opening Main door)
It seems to be locked.

>unlock door
You need a key to unlock the door.

>n
You can't go that way.

>w
Dinning room
The dining room is bright and tidy, with a long wooden table at the center surrounded by sturdy chairs. A small chandelier hangs overhead, casting a warm glow across the room.

You can see a table (on which are News Paper and Breakfast) here.

>n
Bedroom
The bedroom is a quiet, comforting space, with a thick, soft bed tucked against the wall and a warm blanket on the bed. Faint light filters through the curtains, and the gentle hush of the room invites sleep.

You can see a Night stand (on which is Smart phone), a drawer (closed) and Wardrobe (closed) here.

>open drawer
You open the drawer, revealing a key.

* * *

>take key
Taken.

>s
Dinning room
The dining room is bright and tidy, with a long wooden table at the center surrounded by sturdy chairs. A small chandelier hangs overhead, casting a warm glow across the room.

You can see a table (on which are News Paper and Breakfast) here.

* * *

>s
(first opening Main door)
It seems to be locked.

>unlock key
The main door is unlocked.

>s
(first opening Main door)
You run outside .. but its already 8:43 am.. YOU ARE LATE TO THE WORK.

    *** you lost to the monday morning. ***

Would you like to RESTART, RESTORE a saved game, QUIT or UNDO the last command?

>restart
Monday Mornings
An Interactive Fiction by Neha Marlady
Release 1 / Serial number 250428 / Inform 7 v10.1.2 / D

Credits Thanks YouTube channel Zoroarrkk,helped with the setup and tutorial of inform7.
https://inform-7-handbook.readthedocs.io/en/latest/ for helping me in understanding the different concepts of inform7.
And ChatGPT for assistance with English grammar correction.

The time is now 8:00 am Monday Morning, You wake up to the soft glow of the early morning sun filtering through the curtains.
Your target is to get ready to office by 8:30 AM.

Bedroom
The bedroom is a quiet, comforting space, with a thick, soft bed tucked against the wall and a warm blanket on the bed. Faint light filters through the curtains, and the gentle hush of the room invites sleep.

You can see a Night stand (on which is Smart phone), a drawer (closed) and Wardrobe (closed) here.

>examine
What do you want to examine?

>examine night stand
The nightstand is short and sturdy, a smart phone is on the night stand.

On the Night stand is Smart phone.

* * *

>open wardrobe
You open Wardrobe, revealing a pajamas, a casual clothes and a formal clothes.

>wear formal clothes
(first taking the formal clothes)
Perfect clothes to wear to office. You are now set to go to office. Now the time is 8:09 am.

>open drawer
You open the drawer, revealing a key.

* * *

>s
Dinning room
The dining room is bright and tidy, with a long wooden table at the center surrounded by sturdy chairs. A small chandelier hangs overhead, casting a warm glow across the room.

You can see a table (on which are News Paper and Breakfast) here.

>eat breakfast
Yummy breakfast to boost your energy and keep you full for the day. Now the time is 8:21 am.

>e
Hall
The hall is a wide, open space with polished floors and plain walls. A few paintings hang neatly along the sides. The main door is to the south of the hall

You can see Main door, Sofa and TV here.

* * *

>s
(first opening Main door)
It seems to be locked.

>n
You can't go that way.

* * *

>w
Dinning room
The dining room is bright and tidy, with a long wooden table at the center surrounded by sturdy chairs. A small chandelier hangs overhead, casting a warm glow across the room.

You can see a table (on which are News Paper and Breakfast) here.

>n
Bedroom
The bedroom is a quiet, comforting space, with a thick, soft bed tucked against the wall and a warm blanket on the bed. Faint light filters through the curtains, and the gentle hush of the room invites sleep.

You can see a Night stand (on which is Smart phone), a drawer (empty) and Wardrobe (in which are a pajamas and a casual clothes) here.

* * *

>look night stand
The nightstand is short and sturdy, a smart phone is on the night stand.

On the Night stand is Smart phone.

>examine night stand
On Night stand is Mobile phone.

>examine drawer
You can't see any such thing.

>open drawer
You can't see any such thing.

* * *

>look night stand
The nightstand is short and sturdy, a smart phone is on the night stand.

On the Night stand is Smart phone.

>look drawer
The drawer slides open with a faint creak, revealing a shallow space inside, perfect for keeping personal and importandt items.

>look wardrobe
A large wooden wardrobe stands against the wall. Its doors are slightly ajar, revealing an organized collection of clothes inside. On one side, neatly hung pajamas, casual clothes, and formal attire are arranged by type and color.

>use smart phone
You've been so absorbed in your phone, scrolling through notifications and messages, that you didn't even realize how much time has slipped away. Now the time is 8:29 am.

>open wardrobe
You open Wardrobe, revealing a pajamas, a casual clothes and a formal clothes.

>wear formal clothes
Perfect clothes to wear to office. You are now set to go to office. Now the time is 8:36 am.

>i
You are carrying:
  a formal clothes

>s
Dinning room
The dining room is bright and tidy, with a long wooden table at the center surrounded by sturdy chairs. A small chandelier hangs overhead, casting a warm glow across the room.

You can see a table (on which are News Paper and Breakfast) here.

>look
Dinning room
The dining room is bright and tidy, with a long wooden table at the center surrounded by sturdy chairs. A small chandelier hangs overhead, casting a warm glow across the room.

You can see a table (on which are News Paper and Breakfast) here.

>eat breakfast
Yummy breakfast to boost your energy and keep you full for the day. Now the time is 8:48 am.

>w
You can't go that way.

>e
Hall
The hall is a wide, open space with polished floors and plain walls. A few paintings hang neatly along the sides.

You can see Main door, Sofa and TV here.

>e
You can't go that way.

>s
(first opening Main door)
It seems to be locked.

* * *

>open door
It seems to be locked.

>n
You can't go that way.

* * *

>w
Dinning room
The dining room is bright and tidy, with a long wooden table at the center surrounded by sturdy chairs. A small chandelier hangs overhead, casting a warm glow across the room.

You can see a table (on which are News Paper and Breakfast) here.

>n
Bedroom
The bedroom is a quiet, comforting space, with a thick, soft bed tucked against the wall and a warm blanket on the bed. Faint light filters through the curtains, and the gentle hush of the room invites sleep.

You can see a Night stand (on which is Smart phone), a drawer (closed) and Wardrobe (in which are a pajamas and a casual clothes) here.

>open wardrobe
That's already open.

>open drawer
You open the drawer, revealing a key.

* * *

>s
Dinning room
The dining room is bright and tidy, with a long wooden table at the center surrounded by sturdy chairs. A small chandelier hangs overhead, casting a warm glow across the room.

You can see a table (on which are News Paper and Breakfast) here.

>e
Hall
The hall is a wide, open space with polished floors and plain walls. A few paintings hang neatly along the sides.

You can see Main door, Sofa and TV here.

>s
(first opening Main door)
It seems to be locked.

* * *

>unlock door
The main door is unlocked.

>s
(first opening Main door)
You run outside .. but its already 9:04 am.. YOU ARE LATE TO THE WORK.

    *** you lost to the monday morning. ***

Would you like to RESTART, RESTORE a saved game, QUIT or UNDO the last command?

>restart
Monday Mornings
An Interactive Fiction by Neha Marlady
Release 1 / Serial number 250428 / Inform 7 v10.1.2 / D

Credits Thanks YouTube channel Zoroarrkk,helped with the setup and tutorial of inform7.
https://inform-7-handbook.readthedocs.io/en/latest/ for helping me in understanding the different concepts of inform7.
And ChatGPT for assistance with English grammar correction.

The time is now 8:00 am Monday Morning, You wake up to the soft glow of the early morning sun filtering through the curtains.
Your target is to get ready to office by 8:30 AM.

Bedroom
The bedroom is a quiet, comforting space, with a thick, soft bed tucked against the wall and a warm blanket on the bed. Faint light filters through the curtains, and the gentle hush of the room invites sleep.

You can see a Night stand (on which is Smart phone), a drawer (closed) and Wardrobe (closed) here.

>open drawer
You open the drawer, revealing a key.

* * *

>open wardrobe
You open Wardrobe, revealing a pajamas, a casual clothes and a formal clothes.

>wear formal clothes
Perfect clothes to wear to office. You are now set to go to office. Now the time is 8:08 am.

>s
Dinning room
The dining room is bright and tidy, with a long wooden table at the center surrounded by sturdy chairs. A small chandelier hangs overhead, casting a warm glow across the room.

You can see a table (on which are News Paper and Breakfast) here.

* * *

>eat breakfast
Yummy breakfast to boost your energy and keep you full for the day. Now the time is 8:18 am.

>e
Hall
The hall is a wide, open space with polished floors and plain walls. A few paintings hang neatly along the sides.

You can see Main door, Sofa and TV here.

* * *

>unlock door
The main door is unlocked.

>s
(first opening Main door)

>s
You can't go that way.

* * *

>w
Dinning room
The dining room is bright and tidy, with a long wooden table at the center surrounded by sturdy chairs. A small chandelier hangs overhead, casting a warm glow across the room.

You can see a table (on which are News Paper and Breakfast) here.

>e
Hall
The hall is a wide, open space with polished floors and plain walls. A few paintings hang neatly along the sides.

You can see Main door, Sofa and TV here.

* * *

>unlock main door
The main door is unlocked.

* * *

>n
You can't go that way.

>e
You can't go that way.

>w
You can't go that way.

>s
Dinning room
The dining room is bright and tidy, with a long wooden table at the center surrounded by sturdy chairs. A small chandelier hangs overhead, casting a warm glow across the room.

You can see a table (on which are News Paper and Breakfast) here.

>e
Hall
The hall is a wide, open space with polished floors and plain walls. A few paintings hang neatly along the sides.

You can see main door, Sofa and TV here.

>w
Dinning room
The dining room is bright and tidy, with a long wooden table at the center surrounded by sturdy chairs. A small chandelier hangs overhead, casting a warm glow across the room.

You can see a table (on which are News Paper and Breakfast) here.

* * *

>s
You can't go that way.

>n
Bedroom
The bedroom is a quiet, comforting space, with a thick, soft bed tucked against the wall and a warm blanket on the bed. Faint light filters through the curtains, and the gentle hush of the room invites sleep.

You can see a Night stand (on which is Mobile phone), a drawer (closed) and Wardrobe (closed) here.

>e
You can't go that way.

* * *

>e
Hall
The hall is a wide, open space with polished floors and plain walls. A few paintings hang neatly along the sides.

You can see main door, Sofa and TV here.

>s
You can't go that way.

>n
(first opening main door)
You dont seem to  be carrying the key.

* * *

>open drawer
You open the drawer, revealing a key.

* * *

>e
You can't go that way.

>s
(first opening main door)
You can't, since main door leads nowhere.

>n
You can't go that way.

>unlock door
You unlock the door with the key, and it swings open.

>unlock door with key
That doesn't seem to be something you can unlock.

>unlock main door
You unlock the door with the key, and it swings open.

>i
You are carrying:
  a key

>unlock door
You unlock the door with the key, and it swings open.

>drop key
Dropped.

>unlock door
You unlock the door with the key, and it swings open.

>lock door
What do you want to lock main door with?

* * *

>open wardrobe
You open Wardrobe, revealing a pajamas, a casual clothes and a formal clothes.

>wear formal clothes
(first taking the formal clothes)
Perfect clothes to wear to office. You are now set to go to office. Now the time is 8:06 am.

>open drawer
You open the drawer, revealing a key.

* * *

>i
You are carrying:
  a key

>s
Dinning room
The dining room is bright and tidy, with a long wooden table at the center surrounded by sturdy chairs. A small chandelier hangs overhead, casting a warm glow across the room.

You can see a table (on which are News Paper and Breakfast) here.

* * *

>s
(first opening Main door)
It seems to be locked.

>unlock main door
The main door is unlocked.

>s
(first opening Main door)

Garage
You come out of the house, enter garage annd take your car and go to office.

You can see Main door here.

>n
Hall
The hall is a wide, open space with polished floors and plain walls. A few paintings hang neatly along the sides.

You can see Main door, Sofa and TV here.

>w
Dinning room
The dining room is bright and tidy, with a long wooden table at the center surrounded by sturdy chairs. A small chandelier hangs overhead, casting a warm glow across the room.

You can see a table (on which are News Paper and Breakfast) here.

>wear causual clothes
You can't see any such thing.

>n
Bedroom
The bedroom is a quiet, comforting space, with a thick, soft bed tucked against the wall and a warm blanket on the bed. Faint light filters through the curtains, and the gentle hush of the room invites sleep.

You can see a Night stand (on which is Smart phone), a drawer (empty) and Wardrobe (in which is casual clothes) here.

>wear casaul clothes
You can't see any such thing.

* * *

>unlock door
The main door is unlocked.

>s
(first opening Main door)
Horraaayyy!!!,,,You conquered the monday morning.. Have a good day!!!!.

    *** Congratulations!! you won the game of Monday morning. ***

Would you like to RESTART, RESTORE a saved game, QUIT or UNDO the last command?

>restart
Monday Mornings
An Interactive Fiction by Neha Marlady
Release 1 / Serial number 250428 / Inform 7 v10.1.2 / D

Credits Thanks YouTube channel Zoroarrkk,helped with the setup and tutorial of inform7.
https://inform-7-handbook.readthedocs.io/en/latest/ for helping me in understanding the different concepts of inform7.
And ChatGPT for assistance with English grammar correction.

The time is now 8:00 am Monday Morning, You wake up to the soft glow of the early morning sun filtering through the curtains.
Your target is to get ready to office by 8:30 AM.

Bedroom
The bedroom is a quiet, comforting space, with a thick, soft bed tucked against the wall and a warm blanket on the bed. Faint light filters through the curtains, and the gentle hush of the room invites sleep.

You can see a Night stand (on which is Smart phone), a drawer (closed) and Wardrobe (closed) here.

* * *

>wear pajamas
(first taking the pajamas)
Perfect clothes to wear at home. Now the time is 8:06 am.

>i
You are carrying:
  a pajamas (being worn)

>wear casuals
You can't see any such thing.

>wear casual clothes
(first taking the casual clothes)
 You are already wearing a pajamas. You'll need to drop it before putting on something else.

>drop pajamas
(first taking the pajamas off)
 You drop the pajamas. You are now free to wear something else. Now the time is 8:19 am

>i
You are carrying:
  a casual clothes

>drop casual clothes
 You drop the casual clothes. You are now free to wear something else. Now the time is 8:31 am

>i
You are carrying nothing.

>open drawer
You open the drawer, revealing a key.

* * *

>unlock door
The main door is unlocked.

>s
(first opening Main door)
You run outside .. but its already 8:39 am.. YOU ARE LATE TO THE WORK.

    *** you lost to the monday morning. ***

Would you like to RESTART, RESTORE a saved game, QUIT or UNDO the last command?

* * *

>i
You are carrying:
  a pajamas (being worn)

>wear formal clothes
Perfect clothes to wear to office. You are now set to go to office. Now the time is 8:13 am.

>i
You are carrying:
  a formal clothes
  a pajamas

* * *

>wear pajamas
(first taking the pajamas)
Perfect clothes to wear at home. Now the time is 8:06 am.

>wear casuals
You can't see any such thing.

* * *

>wear casual clothes
(first taking the casual clothes)
 You are already wearing a pajamas. You'll need to drop it before putting on something else.

>open warderobe
You can't see any such thing.

>close wardrobe
You close Wardrobe.

>open wardrobe
You open Wardrobe, revealing a formal clothes.

>i
You are carrying:
  a casual clothes
  a pajamas (being worn)

* * *

>open wardrope
You can't see any such thing.

>open wardrobe
You open Wardrobe, revealing a pajamas, a casual clothes and a formal clothes.

>wear pajamas
Perfect clothes to wear at home. Now the time is 8:06 am.

>i
You are carrying nothing.

>wear pajamas
Perfect clothes to wear at home. Now the time is 8:13 am.

>i
You are carrying nothing.

* * *

>s
Dinning room
The dining room is bright and tidy, with a long wooden table at the center surrounded by sturdy chairs. A small chandelier hangs overhead, casting a warm glow across the room.

You can see a table (on which are News Paper and Breakfast) here.

>b
That's not a verb I recognise.

>w
You can't go that way.

>n
You can't go that way.

* * *

>e
Hall
The hall is a wide, open space with polished floors and plain walls. A few paintings hang neatly along the sides.

You can see Main door, Sofa and TV here.

>e
(first opening main door)
You dont seem to  be carrying the key.

>w
Dinning room
The dining room is bright and tidy, with a long wooden table at the center surrounded by sturdy chairs. A small chandelier hangs overhead, casting a warm glow across the room.

You can see a table (on which are News Paper and Breakfast) here.

>w
You can't go that way.

>e
Hall
The hall is a wide, open space with polished floors and plain walls. A few paintings hang neatly along the sides.

You can see main door, Sofa and TV here.

>e
(first opening main door)
You dont seem to carrying the key.

>unlock door
What do you want to unlock main door with?

>open door
You dont seem to carrying the key.

* * *

>e
Hall
The hall is a wide, open space with polished floors and plain walls. A few paintings hang neatly along the sides.

You can see Main door, Sofa and TV here.

>n
(first opening main door)
You dont seem to  be carrying the key.

* * *

>s
(first opening Main door)
It seems to be locked.

>n
(first opening main door)
You dont seem to  be carrying the key.

* * *

>s
(first opening Main door)
It seems to be locked.

>start transcript
That's not a verb I recognise.

* * *

>unlock door
You need a key to unlock the door.

>s
(first opening Main door)
It seems to be locked.

>w
Dinning room
The dining room is bright and tidy, with a long wooden table at the center surrounded by sturdy chairs. A small chandelier hangs overhead, casting a warm glow across the room.

You can see a table (on which are News Paper and Breakfast) here.

>n
Bedroom
The bedroom is a quiet, comforting space, with a thick, soft bed tucked against the wall and a warm blanket on the bed. Faint light filters through the curtains, and the gentle hush of the room invites sleep.

You can see a Night stand (on which is Mobile phone), a drawer (closed) and Wardrobe (closed) here.

>open drawer
You open the drawer, revealing a key.

* * *

>s
Dinning room
The dining room is bright and tidy, with a long wooden table at the center surrounded by sturdy chairs. A small chandelier hangs overhead, casting a warm glow across the room.

You can see a table (on which are News Paper and Breakfast) here.

>w
You can't go that way.

* * *

>s
(first opening Main door)
It seems to be locked.

>unlock
(the key)
The main door is unlocked.

>unlock door
The main door is unlocked.

>s
(first opening Main door)

Garage
You come out of the house, enter garage annd take your car and go to office.

You can see Main door here.

>s
You can't go that way.

>e
You can't go that way.

>n
Hall
The hall is a wide, open space with polished floors and plain walls. A few paintings hang neatly along the sides.

You can see Main door, Sofa and TV here.

* * *

>w
Dinning room
The dining room is bright and tidy, with a long wooden table at the center surrounded by sturdy chairs. A small chandelier hangs overhead, casting a warm glow across the room.

You can see a table (on which are News Paper and Breakfast) here.

>n
Bedroom
The bedroom is a quiet, comforting space, with a thick, soft bed tucked against the wall and a warm blanket on the bed. Faint light filters through the curtains, and the gentle hush of the room invites sleep.

You can see a Night stand (on which is Mobile phone), a drawer (empty) and Wardrobe (closed) here.

>open wardrobe
You open Wardrobe, revealing a pajamas, a casual clothes and a formal clothes.

>i
You are carrying:
  a key

>wear pajamas
Perfect clothes to wear at home. Now the time is 8:30 am.

>wear formals
You can't see any such thing.

>wear formal clothes
Perfect clothes to wear to office. You are now set to go to office. Now the time is 8:36 am.

>i
You are carrying:
  a formal clothes
  a pajamas
  a key

>drop formal clothes
Dropped.

>drop pajamas
Dropped.

>i
You are carrying:
  a key

>take pajamas
You dont have to take the pajamas to wear it.

>i
You are carrying:
  a key

* * *

>n
You can't go that way.

>s
(first opening Main door)
It seems to be locked.

>examine door
The main is opens to the outside world.

>open door
It seems to be locked.

>i
You are carrying nothing.

* * *

>e
Hall
The hall is a wide, open space with polished floors and plain walls. A few paintings hang neatly along the sides.

You can see Main door, Sofa and TV here.

>w
Dinning room
The dining room is bright and tidy, with a long wooden table at the center surrounded by sturdy chairs. A small chandelier hangs overhead, casting a warm glow across the room.

You can see a table (on which are News Paper and Breakfast) here.

>examine table
The long wooden table is set for breakfast, with plates of toast, a bowl of fruit and a pot of hot coffee. A folded newspaper rests at one end waiting to be read.

On the table are News Paper and Breakfast.

>examine breakfast
A hearty breakfast is laid out: a plate of buttered toast, a bowl of fresh fruit, a pot of steaming coffee, and a jar of strawberry jam. The warm, comforting smells fill the air, making the whole room feel inviting.

>eat breakfast
(first taking Breakfast)
You eat Breakfast. Not bad.

>have breakfast
That's not a verb I recognise.

>e
Hall
The hall is a wide, open space with polished floors and plain walls. A few paintings hang neatly along the sides.

You can see Sofa and TV here.

>look
Hall
The hall is a wide, open space with polished floors and plain walls. A few paintings hang neatly along the sides.

You can see Sofa and TV here.

>examine sofa
A large, deep sofa dominates the room, its soft, dark fabric welcoming you to sit. The cushions are plump and perfectly arranged, with a cozy throw blanket draped across one armrest. It looks like the ideal place for a lazy afternoon.

>examine TV
The television is on, showing the morning news. The anchor speaks calmly, going over the day's headlines from the weather to local events and even a sports update. It's a typical start to the day with everything you need to know at a glance.

>watch TV
The television is on, showing the morning news. The anchor speaks calmly, going over the day's headlines from the weather to local events and even a sports update. It's a typical start to the day with everything you need to know at a glance.

* * *

>s
Dinning room
The dining room is bright and tidy, with a long wooden table at the center surrounded by sturdy chairs. A small chandelier hangs overhead, casting a warm glow across the room.

You can see a table (on which are News Paper and Breakfast) here.

>n
Bedroom
The bedroom is a quiet, comforting space, with a thick, soft bed tucked against the wall and a warm blanket on the bed. Faint light filters through the curtains, and the gentle hush of the room invites sleep.

You can see a Night stand (on which is Mobile phone), a drawer (closed) and Wardrobe (closed) here.

* * *

>w
You can't go that way.

>s
dinning room
The dining room is bright and tidy, with a long wooden table at the center surrounded by sturdy chairs. A small chandelier hangs overhead, casting a warm glow across the room.

>e
hall
The hall is a wide, open space with polished floors and plain walls. A few paintings hang neatly along the sides.

>e
main door

* * *

>n
Bedroom
The bedroom is a quiet, comforting space, with a thick, soft bed tucked against the wall and a warm blanket on the bed. Faint light filters through the curtains, and the gentle hush of the room invites sleep.

You can see a Night stand (on which is Mobile phone), a drawer (closed) and Wardrobe (closed) here.

>examine wardrobe
A large wooden wardrobe stands against the wall. Its doors are slightly ajar, revealing an organized collection of clothes inside. On one side, neatly hung pajamas, casual clothes, and formal attire are arranged by type and color.

* * *

>open wardrobe
You open Wardrobe, revealing a pajamas, a casual clothes and a formal clothes.

>wear pajamas
Perfect clothes to wear at home. Now the time is 8:09 am.

>take pajamas
You dont have to take the pajamas to wear it.

>wear pajamas
Perfect clothes to wear at home. Now the time is 8:16 am.

>i
You are carrying:
  a pajamas

>drop pajamas
Dropped.

>i
You are carrying nothing.

>wear pajamas
Perfect clothes to wear at home. Now the time is 8:25 am.

>take pajamas
You dont have to take the pajamas to wear it.

>i
You are carrying:
  a pajamas

>wear formal clothes
Perfect clothes to wear to office. You are now set to go to office. Now the time is 8:33 am.

>i
You are carrying:
  a formal clothes
  a pajamas

>look
Bedroom
The bedroom is a quiet, comforting space, with a thick, soft bed tucked against the wall and a warm blanket on the bed. Faint light filters through the curtains, and the gentle hush of the room invites sleep.

You can see a Night stand (on which is Mobile phone), a drawer (closed) and Wardrobe (in which is a casual clothes) here.

>s
Dinning room
The dining room is bright and tidy, with a long wooden table at the center surrounded by sturdy chairs. A small chandelier hangs overhead, casting a warm glow across the room.

You can see a table (on which are News Paper and Breakfast) here.

>watch news paper
A neatly folded newspaper lies on the table, the front page flashing an exciting headline about a thrilling last-minute victory in last night's big game. It's the kind of story that makes you want to read every detail.

>examine newspaper
You can't see any such thing.

>examine news paper
A neatly folded newspaper lies on the table, the front page flashing an exciting headline about a thrilling last-minute victory in last night's big game. It's the kind of story that makes you want to read every detail.

>read news paper
Lost in the stories and headlines of the newspaper, you barely notice the minutes ticking by. Now the time is 8:54 am.

>eat breakfast
Yummy breakfast to boost your energy and keep you full for the day. Now the time is 9:03 am.

>e
Hall
The hall is a wide, open space with polished floors and plain walls. A few paintings hang neatly along the sides.

You can see main door, Sofa and TV here.

>watch tv
 The news headline and then the sports news took your time that you did not notice the time. Now the time is 9:35 am.

>sit on sofa
Comfy sofa, best place to sit and relax or Watch TV. Now the time is 9:38 am.

>sit sofa
I didn't understand that sentence.

>sit down
I didn't understand that sentence.

>i
You are carrying:
  a formal clothes
  a pajamas

>sit on sofa
Comfy sofa, best place to sit and relax or Watch TV. Now the time is 9:42 am.

>watch tv
 The news headline and then the sports news took your time that you did not notice the time. Now the time is 10:13 am.

>s
You can't go that way.

* * *

>sleep
You slept for a long time and now you are too late for office.Now the time is 9:00 am.

>scroll
(Mobile phone)
You've been so absorbed in your phone, scrolling through notifications and messages, that you didn't even realize how much time has slipped away. Now the time is 9:26 am.

>scroll neha
You can't see any such thing.

>scroll house
You can't see any such thing.

>scroll phone
You've been so absorbed in your phone, scrolling through notifications and messages, that you didn't even realize how much time has slipped away. Now the time is 9:52 am.

>scroll mobile
You've been so absorbed in your phone, scrolling through notifications and messages, that you didn't even realize how much time has slipped away. Now the time is 10:18 am.